SP	SP
AP	AP
cl	cl
vf	vf
mlem	mlem
a	a
A	A
e	e
er	er
E	E
i	i
I	I
ih	ih
ia	ia
iA	iA
iO	iO
ii	ii
ie	ie
O	O
u	u
ua	ua
uo	uo
U	U
uA	uA
uE	uE
yu	yu
yI	yI
yE	yE
V	V
b	b
c	c
ch	ch
d	d
f	f
g	g
h	h
j	j
k	k
l	l
m	m
n	n
N	N
ng	ng
p	p
q	q
r	r
rr	rr
s	s
sh	sh
t	t
w	w
x	x
y	y
z	z
zh	zh
